...###
..##.#.##.#
.##..###..#
##........#
#..#.#.#..#
########..#
..#..#....#
.##.##.#.##
.#..@...##
.#.....##